Dog		หมา
Cow		วัว
Cat		แมว
Guitar		กีตาร์
Morning		ตอนเช้า
Afternoon		ตอนบ่าย
Evening		ตอนเย็น	
Play		เล่น
Red		สีแดง
Blue		สีน้ำเงิน
Yellow		สีเหลือง
Green		สีเขียว
Orange		ส้ม
Purple		สีม่วง
Pink		สีชมพู
Black		สีดำ
Brown		สีน้ำตาล
White		ขาว
Zero		ศูนย์
One		หนึ่ง
Two		สอง
Three		สาม
Four		สี่
Five		ห้า
Six		หก
Seven		เจ็ด
Eight		แปด
Nine		เก้า
Ten		สิบ
Family		ครอบครัว
Father		พ่อ
Mother		แม่
Brother		พี่ชาย
Sister		น้องสาว
Grandma		ยาย
Grandpa		คุณปู่